++++++++++++++========++++++++++++===-----::---=---=============================
*#**********++++++++++++++++++++++++***###@%%%░░:::-=-==========================
%%@#######******+#@++++++++++***@░▓▒▒▓▒▒█▒▒▓▒░▒▒:::-=-==========================
##%%%%%%%@@@%%%%@@%*++++++++**#+@░▓▒░▓░░▓░░▒░░▒░:::-=-==========================
*+%░%@@%%@@@@@%%%@%#+++++++***#*@░▒▒▒▓░▒▓▒░░▒▒▒%-::-=-==========================
░░░░%%%@@@@@@@@@%@%@++++++****#+#@%▒▒▓░░▒▓%%░▒░@-::-=-==========================
%░░░%%@@@@@@@@@@@@@%**********#**@%▒▒▒░░▒▒%%░▒░@-::-============================
%%░%%%@@@@@@@@@@@%%%#*********#*@░▒▓▒▓▓▒▓▒▒▓▒▒▓▒-::-============================
░░░░░░%%%%░░░░░%@@%%#**#****#@%%@%▒▓▒▓▓░▓▒░▓▓░▓▓=::-=-==========================
▒░░░%@@#####░░░%%%%%%%%%@###@▓██░%▒▒▓▓▓▓▓▓▒▓▓▒▒▓=:-#%%@########********+++++++==
░=---::::::-@%@@@@@@######@#░▓▓▓▓▓░▒▓▓▓███▒░▒▓▓░+-=%▓▓░@@@@@@@@@@@@@@@@@@@@@@@@@
░+---------@@@@@@@@@@@@@@@@@▓███▓█░░▒▓▓▓██▓▓▒▓▓░+-#░▓▒░@@@@@@@@@@@@@@@@@@@@@@@@@
▒#=--+*+===++%%@@@###**+++*#%░▒▒▓▒##▒█▓▓▓▓▓█░░░░=.@█▓▓▓▒@@@@@@@@@@@@@@@@@@@@@@@@
#@+-===@▓▒#+=++===--------=+=+++*+=+#@%░░▒▓▓####=.:%▓▓▒▓░@@@@@@@@@@@@@@@@@@@@@@@
▓░*+==+*▓▓#+--------=======*++++++-------====+++=::+▒▒▓▓▓▒%%%%%@@@@@@@@@@@@@@@@@
▓▓▒▒%*++==-=----------------===+++==#+--=------::::--==+*#**#@*@%%%%%%%%%@@@@@@@
▓▓▓▓█##░░%@++=:---:::::::::::---==+*+=::-------::::-:::::::::::--==++*##@@@%%%%%
█████%░░▓██▒++-:---::::::::::::::::--::::::::::---:::::-----::::::::::::::--==+*
███▓▓▓▓▓▒▒██▒++=::::-::::::::::::::::::::::::--====++===--::::::::::::::::::::::
▓▒▒▒▒▒▒▓▓▒▒██▒=*@+-:.::::::::::::::::::::::::::::----===+++=::::::::::::::::::::
▓▒▒▒▒▒▓▓▓▓▒███▒+@█▓░#+-:::::::::::::::::::::------::::::::::::::::::::::::::::::
▓▒▒▒▒▓▓▓▓▓▓@%▒█▒=@████▓@*=::::::::::::::--------::::::::::::::::::::::::::::::::